
$                  #
#             #############
############    #         # #       ##     ##     ##
#  #         #       # # #       ##     ##     ##
#  #     #####       # # #       ##     ##     ##
#  #     #   #       # # #       ##     ##     ##
#  #         #       # # #       ##     ##     ##
$###############       # # ##########     #########
# #        ########## # #       ##          #####
# ###########       # # #####   ##            ####
# #        ########## # #       #######        ##
# #            #    # $ #       ##    #        ##
# #            #    # # #       ################
# #   #        #    # # #       ##    #        ##
# #   #     ######### # #       ##    #        ##
#$#####    # #     # ## #       ##    #        ##
#   #    ####    # #  #       ##            ##
##############    #####       ###############$
