
$                  #
#             #############
############    #         # #       ##     ##     ##
#  #         #       # # #       ##     ##     ##
#  #     #####       # # #       ##     ##     ##
#  #     #   #       # # #       ##     ##     ##
#  #         #       # # #       ##     ##     ##
$###############       # # ##########     #########
# #        ########## # #       ##            ##
# ###########       # # #####   ##            ##
# #        ########## # #       ##            ##
# #            #    # # #       ##            ##
# #            #    # # #       ##            ##
# #   #        #    # # #       ##            ##
# #   #     ######### # #       ##            ##
#######    # #     # ## #       ##            ##
#   #    ####    # #  #       ##            ##
##############    #####       ###############$
