
$                  #
#             ###########
############    #         #
#         #       # #
#     #####       # #
#     #   #       # #
#         #       # #
$###############       # #
#   #     ########## #
#   #    #$       # #
# # # #  ##       # # #   #
#   #               # ######
#   #             # #    # #
#   #             # #    ###
#   #     ######### #    #
######    # #     # ##   #
#   #    ####    # ##    ###
##############    ########
### ########## ####$#    #
