
$                  #
#             ###########
############    #         #
#         #       # #
#     #####       # #
#     #   #       # #
#         #       # #
$###############       # #
#   #     ########## #
#   #    ##       # #
# # # #  ##       # #
#   #               # #
#   #             # #
#   #             # #
#   #     ######### #
######    # #     # ##
#   #    ####    # ##
##############    ###
### ########## ####$
